11111111111111111
1000C1000011100C1
1C101001000001001
1E1000011000000P1
11111111111111111
