11111111111111111
10000100001110001
1E10100101C100001
101000011010000P1
11111111111111111